1111111111111
1C010C00000C1
100C011111K01
1P0011E000001
1111111111111
