1111111111111
1C010C00000C1
100E011111K01
1PK011C000001
1111111111111
