1111111111111
10C1000000001
1000011111K01
1PK011E000001
1111111111111
